        Not Fade Away         	E maj	Std
Let's Spend the Night Together	D maj	Std
       Get Off My Cloud       	E maj	Std
        Heart Of Stone        	C maj	Std
        Under My Thumb        	F# min	Std
      Time Is On My Side      	F maj	Std
            Carol             	A maj	Std
         Love In Vain         	G maj	Std
         Live With Me         	A maj	Std
         Let It Bleed         	D maj	Std
        Gimme Shelter         	C# maj	E
      Jumpin Jack Flash       	B maj	E

         TUNING BREAK         

          Monkey Man          	E maj	Std	2
        Paint It Black        	E min	Std	2

         TUNING BREAK         

    Sympathy for the Devil    	E maj	Std
     Street Fighting Man      	B maj	G	4

         TUNING BREAK         

         Start Me Up          	F maj	G

         TUNING BREAK         

         Tumblin Dice         	B maj	G	4

         TUNING BREAK         

      All Down The Line       	G maj	G
  Can't You Hear Me Knockin   	D maj	G
        She's So Cold         	G maj	Std
       Emotional Rescue       	Bb maj	Std
          Hang Fire           	A maj	Std
   Before They Make Me Run    	G maj	G
       Honky Tonk Women       	G maj	G
         Brown Sugar          	C maj	G
   It's Only Rock and Roll    	E maj	Std
         Dead Flowers         	D maj	Std
           Miss You           	A min	Std
       Beast of Burden        	E maj	Std
          Rocks Off           	E maj	Std
         Satisfaction         	E maj	E
